45   53  -22   31   91  -69  -92   81  -36 
54  -91  -19   59   57   19   73   96   64 
79  -84  -68  -49  -64   32  -13   85   84 
-14   35   56  -29   80  -84   59   10   52 
-26   97  -77  -76  -19   14  -28  -31   40 
-33   95   77   64   52   62  -16  -67  -23 
-74  -14   97  -11  -86  -29  -38  -86   39 
76   43   62   71   84  -37   42   91  -65 
-27  -16   34  -73  -72   13  -63  -10  -11 
43